Did she hear that? I was just trying to do a downward dog… Why did my body have to betray me like that?  I hope she doesn't smell that…  My stomach really hurts.  I should use the restroom.

Bowel Troubles
An Interactive Fiction by Kyler Matsuura
Release 1 / Serial number 140303 / Inform 7 build 6G60 (I6/v6.32 lib 6/12N) SD

Yoga Studio
You and your Yoga Instructor are the only people in the room.  You were having a private yoga session because your psychiatrist recommended it would help; You know, with your anger issues and such.  In the corner of the room, your wallet and sleeping medicine sits on the stack of yoga mats right where you left them. 

You can see a Restroom Door and Yoga Instructor here.

I beg your pardon?

* * *

>x mat
You can't see any such thing.

>x Mat
You can't see any such thing.

* * *

>x mat
You can't see any such thing.

>x yoga mat
You can't see any such thing.

>x yoga mats
A stack of dirty yoga mats.  It seems that they were recently used.

* * *

>attack instructor
You hit her with full force, but it barely fazes her.  She puts you in headlock until the cops show up.  You have been arrested.

    *** You're going to jail for a long time. ***

In that game you scored 0 out of a possible 0, in 1 turn.

Would you like to RESTART, RESTORE a saved game, QUIT or UNDO the last command?

* * *

>south
Strip 1
This is the first half of the strip.  To the south is Longs, to the north is the Yoga Studio, and to the east is the Strip 2

>south
Longs
It's just like every other Longs store. The Laxatives can be found in the Drug Cabinet.

You can see Security Guard and Drug Cabinet (closed) here.

>open drug cabinet
You open Drug Cabinet, revealing Medecine.

>take medecine
Taken.

>north
You must supply a noun.

>north
You must supply a noun.

>leave
But you aren't in anything at the moment.

>leave longs
I only understood you as far as wanting to leave.

>leave longs
I only understood you as far as wanting to leave.

>north
You must supply a noun.

* * *

>south
Longs
It's just like every other Longs store. The Laxatives can be found in the Drug Cabinet.

You can see Security Guard and Drug Cabinet (closed) here.

>take medecine
Taken.

>north
Strip 1
This is the first half of the strip.  To the south is Longs, to the north is the Yoga Studio, and to the east is the Strip 2

>north
Yoga Studio
You and your Yoga Instructor are the only people in the room.  You were having a private yoga session because your psychiatrist recommended it would help; You know, with your anger issues and such.  In the corner of the room, your wallet and sleeping medicine sits on the stack of yoga mats right where you left them. 

You can see a Restroom Door and Yoga Instructor here.

>slip medecine under door
Thanks You! But it would seem the door is jammed… If you want to use the bathroom, you'll need to find a way to open this door.

* * *

>slip medecine under
(the Restroom Door)

I beg your pardon?

* * *

>north
Yoga Studio
You and your Yoga Instructor are the only people in the room.  You were having a private yoga session because your psychiatrist recommended it would help; You know, with your anger issues and such.  In the corner of the room, your wallet and sleeping medicine sits on the stack of yoga mats right where you left them. 

You can see a Restroom Door and Yoga Instructor here.

>slip medecine under restroom door
Thanks You! But it would seem the door is jammed… If you want to use the bathroom, you'll need to find a way to open this door.

* * *

>north
Strip 1
This is the first half of the strip.  To the south is Longs, to the north is the Yoga Studio, and to the east is the Strip 2

>nort
That's not a verb I recognise.

>north
Yoga Studio
You and your Yoga Instructor are the only people in the room.  You were having a private yoga session because your psychiatrist recommended it would help; You know, with your anger issues and such.  In the corner of the room, your wallet and sleeping medicine sits on the stack of yoga mats right where you left them. 

You can see a Restroom Door and Yoga Instructor here.

>open door
"Hey! It's in use! Wait…  You need to use the restroom too?  Well it seems we can help each other.  If you want to use the restroom, go get me medecine," says the mysterious voice on the other side of the door. Thanks Bud, now just slip it under the door.

* * *

>south
Longs
It's just like every other Longs store. The Laxatives can be found in the Drug Cabinet.

You can see Security Guard and Drug Cabinet (closed) here.

>open cabinet
You open Drug Cabinet, revealing Medecine.

>take medecine
Taken.

>north
    *** The security guard caught you trying to steal! ***

In that game you scored 0 out of a possible 0, in 5 turns.

Would you like to RESTART, RESTORE a saved game, QUIT or UNDO the last command?

>r
That's not a verb I recognise.

>undo
Longs
[Previous turn undone.]

>undo
Longs
[Previous turn undone.]

>undo
Strip 1
[Previous turn undone.]

>north
You must supply a noun.

* * *

>south
Strip 1
This is the first half of the strip.  To the south is Longs, to the north is the Yoga Studio, and to the east is the Strip 2

>east
Strip 2
This is the second half of the strip.  To the North is the Happy Shooting.  To the South is the Cafe.  To the West is the Strip 1.

>south
Cafe
A cafe.

You can see Silver Key here.

>take key
Taken.

>east
You can't go that way.

>north
Strip 2
This is the second half of the strip.  To the North is the Happy Shooting.  To the South is the Cafe.  To the West is the Strip 1.

>north
Happy Shooting
This gun store is void of all life.  The interior of the store is a very dull grey color that is completely opposite of the store's name. In the back of the room, there is a register and a cabinent that is filled with guns.  In the top corner of the room, there is a security camera that can that view your every move.  Just outside the camera's view is a door.

You can see a metal door and a Cabinent (closed) here.

>unlock metald oor
You can't see any such thing.

>unlock metal door
(with Silver Key)
You unlock the metal door.

>east
(first opening the metal door)

Security Room
This room has one monitor screen that overlooks the Gun Store.  Below the monitor is a Red Switch.

You can see a metal door, Case Key and Red Switch here.

>take case key
Taken.

>west
Happy Shooting
This gun store is void of all life.  The interior of the store is a very dull grey color that is completely opposite of the store's name. In the back of the room, there is a register and a cabinent that is filled with guns.  In the top corner of the room, there is a security camera that can that view your every move.  Just outside the camera's view is a door.

You can see a metal door and a Cabinent (closed) here.

>unlock cabinent
What do you want to unlock the Cabinent with?

>case key
You unlock the Cabinent.

>open cabinent
You open the Cabinent, revealing Gun.

>take gun
    *** You've been caught by the cops for stealing! ***

In that game you scored 0 out of a possible 0, in 14 turns.

Would you like to RESTART, RESTORE a saved game, QUIT or UNDO the last command?

* * *

>south
Cafe
A cafe.

You can see Silver Key here.

>take silver key
Taken.

>north
Strip 2
This is the second half of the strip.  To the North is the Happy Shooting.  To the South is the Cafe.  To the West is the Strip 1.

* * *

>north
Happy Shooting
This gun store is void of all life.  The interior of the store is a very dull grey color that is completely opposite of the store's name. In the back of the room, there is a register and a cabinent that is filled with guns.  In the top corner of the room, there is a security camera that can that view your every move.  Just outside the camera's view is a door.

You can see a metal door and a Cabinent (closed) here.

>east
(first opening the metal door)
It seems to be locked.

>east
(first opening the metal door)
It seems to be locked.

>unlock metal door with silver key
You unlock the metal door.

>open
(Silver Key)
That's not something you can open.

>east
(first opening the metal door)

Security Room
This room has one monitor screen that overlooks the Gun Store.  Below the monitor is a Red Switch.

You can see a metal door, Case Key and Red Switch here.

>switch on red switch
You switch Red Switch on.

>west
Happy Shooting
This gun store is void of all life.  The interior of the store is a very dull grey color that is completely opposite of the store's name. In the back of the room, there is a register and a cabinent that is filled with guns.  In the top corner of the room, there is a security camera that can that view your every move.  Just outside the camera's view is a door.

You can see a metal door and a Cabinent (closed) here.

>west
You can't go that way.

>east
Security Room
This room has one monitor screen that overlooks the Gun Store.  Below the monitor is a Red Switch.

You can see a metal door, Case Key and Red Switch here.

* * *

>west
Happy Shooting
This gun store is void of all life.  The interior of the store is a very dull grey color that is completely opposite of the store's name. In the back of the room, there is a register and a cabinent that is filled with guns.  In the top corner of the room, there is a security camera that can that view your every move.  Just outside the camera's view is a door.

You can see a metal door and a Cabinent (closed) here.

>open cabinent
It seems to be locked.

>unlock cabinent
What do you want to unlock the Cabinent with?

* * *

>open cabinent
You open the Cabinent, revealing Gun.

>take gun
You pick up the Gun and quickly hide it in your pocket.

>restart
Are you sure you want to restart?

* * *

>open restroom door
"Hey! It's in use! Wait…  You need to use the restroom too?  Well it seems we can help each other.  If you want to use the restroom, go get me medecine," says the mysterious voice on the other side of the door.

>south
Strip 1
This is the first half of the strip.  To the south is Longs, to the north is the Yoga Studio, and to the east is the Strip 2

>south
Longs
It's just like every other Longs store. The Laxatives can be found on the Medicine shelve.

You can see Medecine here.

>take medecine
Taken.

>x medecine
Laxatives

>north
Strip 1
This is the first half of the strip.  To the south is Longs, to the north is the Yoga Studio, and to the east is the Strip 2

* * *

>north
Yoga Studio
You and your Yoga Instructor are the only people in the room.  You were having a private yoga session because your psychiatrist recommended it would help; You know, with your anger issues and such.  In the corner of the room, your wallet and sleeping medicine sits on the stack of yoga mats right where you left them. 

You can see a Restroom Door and Yoga Instructor here.

>open door
"Hey! It's in use! Wait…  You need to use the restroom too?  Well it seems we can help each other.  If you want to use the restroom, go get me medecine," says the mysterious voice on the other side of the doorThanks Bud, now just slip it under the door.

* * *

>talk to mysteroius voice
You can't see any such thing.

* * *

>x instructor
A 60 year old women who has bigger muscles than you do.  Close up, you can smell the scent of fresh vegetables.

>x everyone else
You can't see any such thing.

* * *

>outh
That's not a verb I recognise.

>south
Strip 1
This is the first half of the strip.  To the south is Longs, to the north is the Yoga Studio, and to the east is the Strip 2

* * *

>x gun
You can't see any such thing.

I beg your pardon?

* * *

>x yoga mats
A stack of dirty yoga mats.  It seems that they were recently used.

* * *

>open door
"Hey! It's in use! Wait…  You need to use the restroom too?  Well it seems we can help each other.  If you want to use the restroom, go get me medecine," says the mysterious voice on the other side of the door.

>south
Strip 1
This is the first half of the strip.  To the south is Longs, to the north is the Yoga Studio, and to the east is the Strip 2

* * *

>north
Yoga Studio
You and your Yoga Instructor are the only people in the room.  You were having a private yoga session because your psychiatrist recommended it would help; You know, with your anger issues and such.  In the corner of the room, your wallet and sleeping medicine sits on the stack of yoga mats right where you left them. 

You can see a Restroom Door and Yoga Instructor here.

>open door
"Hey! It's in use! Wait…  You need to use the restroom too?  Well it seems we can help each other.  If you want to use the restroom, go get me medecine," says the mysterious voice on the other side of the door. Oh… You already have the medecine?  Thanks Bud, now just slip it under the door.

>slip medecine under door
I didn't understand that sentence.

* * *

>souths
That's not a verb I recognise.

>south
Strip 1
This is the first half of the strip.  To the south is Longs, to the north is the Yoga Studio, and to the east is the Strip 2

* * *

>open door
"Hey! It's in use! Wait…  You need to use the restroom too?  Well it seems we can help each other.  If you want to use the restroom, go get me medecine," says the mysterious voice on the other side of the door. Oh… You already have the medecine?  Thanks Bud, now just slip it under the door.

>slip under door
Thanks You! But it would seem the door is jammed… If you want to use the bathroom, you'll need to find a way to open this door.

>i
You are carrying nothing.

* * *

>x yoga mat
You can't see any such thing.

>take yoga mat
You can't see any such thing.

* * *

>x yoga mat
You can't see any such thing.

>x yoga mats
You see nothing special about Yoga Mats.

>talk to instructor
You need to use the restroom?  It's to the east.

* * *

>x yoga mat
You can't see any such thing.

>x yogamat
You can't see any such thing.

>x Yoga Mat
You can't see any such thing.

* * *

>talk to instructor
You need to use the restroom?  It's to the east.