Did she hear that? I was just trying to do a downward dog… Why did my body have to betray me like that?  I hope she doesn't smell that…  My stomach really hurts.  I should use the restroom.

Bowel Troubles
An Interactive Fiction by Kyler Matsuura
Release 1 / Serial number 140221 / Inform 7 build 6G60 (I6/v6.32 lib 6/12N) SD

Yoga Studio
You and your Yoga Instructor are the only people in the room.  You were having a private yoga session because your psychiatrist recommended it would help; You know, with your anger issues and such.  In the corner of the room, your wallet and sleeping medicine sits on the stack of yoga mats right where you left them. 

You can see a Restroom Door and Yoga Instructor here.

I beg your pardon?

* * *

>x mat
You can't see any such thing.

* * *

>talk to mysteroius voice
You can't see any such thing.

* * *

>attack instructor
You hit her with full force, but it barely fazes her.  She puts you in headlock until the cops show up.  You have been arrested.

    *** You're going to jail for a long time. ***

In that game you scored 0 out of a possible 0, in 1 turn.

Would you like to RESTART, RESTORE a saved game, QUIT or UNDO the last command?

* * *

>south
Strip 1
This is the first half of the strip.  To the south is Longs and to the nort is the Yoga Studio.

* * *

>x instructor
A 60 year old women who has bigger muscles than you do.  Close up, you can smell the scent of fresh vegetables.

* * *

>east
(first opening the Restroom Door)
It seems to be locked.

>open restroom door
It seems to be locked.

* * *

>x gun
You can't see any such thing.

* * *

>x yoga mats
A stack of dirty yoga mats.  It seems that they were recently used.

* * *

>x restroom door
It seems to be jammed shut.  On the other side is the restroom.  Someone seems to be inside of it.

>open restroom door
"Hey! It's in use! Wait…  You need to use the restroom too?  Well it seems we can help each other.  If you want to use the restroom, go get me laxatives," says the mysterious voice on the other side of the door

* * *

>x yoga mat
You can't see any such thing.

* * *

>talk to instructor
You need to use the restroom?  It's to the east.

>east
(first opening the Restroom Door)
"Hey! It's in use! Wait…  You need to use the restroom too?  Well it seems we can help each other.  If you want to use the restroom, go get me laxatives," says the mysterious voice on the other side of the door

* * *

>talk to yoga instructor
You can't see any such thing.