>south
Strip 1
This is the first half of the strip.  To the south is Longs, to the north is the Yoga Studio, and to the east is the Strip 2

You can see Sleeping Drug here.

>east
Strip 2
This is the second half of the strip.  To the North is the Happy Shooting.  To the South is the Cafe.  To the West is the Strip 1.

You can see Hobo here.

>give hobo change
Hobo is so happy that he gives you his cherished item.

>open container
You open Secret Container.

>ewst
That's not a verb I recognise.

>west
Strip 1
This is the first half of the strip.  To the south is Longs, to the north is the Yoga Studio, and to the east is the Strip 2

You can see Sleeping Drug here.

>take drug
Taken.

>south
Longs
It's just like every other Longs store. The Laxatives can be found in the Drug Cabinet.

You can see Security Guard and Drug Cabinet (closed) here.

>open cabinet
You open Drug Cabinet, revealing Medicine.

>take medicine
Taken.

* * *

>put medicine in container
You put Medicine into Secret Container.

>north
Strip 1
This is the first half of the strip.  To the south is Longs, to the north is the Yoga Studio, and to the east is the Strip 2

>east
Strip 2
This is the second half of the strip.  To the North is the Happy Shooting.  To the South is the Cafe.  To the West is the Strip 1.

You can see Hobo here.

>south
Cafe
An empty cafe with rows of emtpy tables.  In the corner of the room is a Old man drinking coffee and reading the newspaper.  On his table is a Silver Key.

You can see Old Man, Coffee (empty), Newspaper and Silver Key here.

* * *

>open container
You open Secret Container.

>west
Strip 1
This is the first half of the strip.  To the south is Longs, to the north is the Yoga Studio, and to the east is the Strip 2

You can see Sleeping Drug here.

>south
Longs
It's just like every other Longs store. The Laxatives can be found in the Drug Cabinet.

You can see Security Guard and Drug Cabinet (closed) here.

* * *

>put medicine in container
You put Medicine into Secret Container.

>north
Strip 1
This is the first half of the strip.  To the south is Longs, to the north is the Yoga Studio, and to the east is the Strip 2

You can see Sleeping Drug here.

>north
Yoga Studio
You and your Yoga Instructor are the only people in the room.  You were having a private yoga session because your psychiatrist recommended it would help; You know, with your anger issues and such.  In the corner of the room is a stack of yoga mats. To the south is the Strip.

You can see a Restroom Door and Yoga Instructor here.

>open door
"Hey! It's in use! Wait…  You need to use the restroom too?  Well it seems we can help each other.  If you want to use the restroom, go get me medicine," says the mysterious voice on the other side of the door. When you do, slip the medicine under the door.

>slip medicine under door
Thanks You! But it would seem the door is jammed… If you want to use the bathroom, you'll need to find a way to open this door.

>open door
"Hey! It's in use! Wait…  You need to use the restroom too?  Well it seems we can help each other.  If you want to use the restroom, go get me medicine," says the mysterious voice on the other side of the door. When you do, slip the medicine under the door.

* * *

>east
Strip 2
This is the second half of the strip.  To the North is the Happy Shooting.  To the South is the Cafe.  To the West is the Strip 1.

You can see Hobo here.

>west
Strip 1
This is the first half of the strip.  To the south is Longs, to the north is the Yoga Studio, and to the east is the Strip 2

You can see Sleeping Drug here.

>take sleeping drug
Taken.

>east
Strip 2
This is the second half of the strip.  To the North is the Happy Shooting.  To the South is the Cafe.  To the West is the Strip 1.

You can see Hobo here.

>south
Cafe
An empty cafe with rows of emtpy tables.  In the corner of the room is a Old man drinking coffee and reading the newspaper.  On his table is a Silver Key.

You can see Old Man, Cup (in which is Coffee), Newspaper and Silver Key here.

>put drug in cup
You put Sleeping Drug into Cup.

>take key
You take the man's silver key while he is asleep.

>north
Strip 2
This is the second half of the strip.  To the North is the Happy Shooting.  To the South is the Cafe.  To the West is the Strip 1.

You can see Hobo here.

>north
Happy Shooting
This gun store is void of all life.  The interior of the store is a very dull grey color that is completely opposite of the store's name. In the back of the room, there is a cabinent that is filled with guns.  In the top corner of the room, there is a security camera that can that view your every move.  Just outside the camera's view is a door.  To the East is the Security Room, which is locked, and to the South is the Strip 2.

You can see a metal door and a Steel Cabinet (closed) here.

* * *

>key
You unlock the metal door.

>open metal door
You open the metal door.

>east
Security Room
This room has one monitor screen that overlooks the Gun Store.  Below the monitor is a Red Switch.

You can see a metal door, Case Key and Red Switch here.

>take case key
Taken.

>x red switch
It seems to toggle the Security Camera. .

Red Switch is currently switched off.

>press red switch
Nothing obvious happens.

>switch red switch on
You switch Red Switch on.

>turn red switch off
You switch Red Switch off.

>press red switch on
You can't see any such thing.

>turn red switch on
You switch Red Switch on.

>west
Happy Shooting
This gun store is void of all life.  The interior of the store is a very dull grey color that is completely opposite of the store's name. In the back of the room, there is a cabinent that is filled with guns.  In the top corner of the room, there is a security camera that can that view your every move.  Just outside the camera's view is a door.  To the East is the Security Room, which is locked, and to the South is the Strip 2.

You can see a metal door and a Steel Cabinet (closed) here.

* * *

>take gun
You pick up the Gun and quickly hide it in your pocket.

>south
Strip 2
This is the second half of the strip.  To the North is the Happy Shooting.  To the South is the Cafe.  To the West is the Strip 1.

You can see Hobo here.

>west
Strip 1
This is the first half of the strip.  To the south is Longs, to the north is the Yoga Studio, and to the east is the Strip 2

>north
Yoga Studio
You and your Yoga Instructor are the only people in the room.  You were having a private yoga session because your psychiatrist recommended it would help; You know, with your anger issues and such.  In the corner of the room is a stack of yoga mats. To the south is the Strip.

You can see a Restroom Door and Yoga Instructor here.

* * *

>south
Cafe
An empty cafe with rows of emtpy tables.  In the corner of the room is a Old man drinking coffee and reading the newspaper.  On his table is a Silver Key.

You can see Old Man, Cup (in which is Coffee), Newspaper and Silver Key here.

>x old man
He's dressed in rugged jeans and a Happy Shooting T-Shirt.  He seems to be reading the newspaper and drinking some coffee.  On his table is a Silver Key.

>talk to old man
He looks at you, and then back to his newspaper.

>x newspaper
Honolulu Star Advertiser.  The top story: Surfer jailed for attacking another Surfer.

>x coffee
Black.  This is the coffee the Old Man is drinking.

>x key
A silver key that seems to unlock a door…

>put sleeping drug in coffee
That can't contain things.

>put sleeping drug in coffee
That can't contain things.

* * *

>south
Strip 1
This is the first half of the strip.  To the south is Longs, to the north is the Yoga Studio, and to the east is the Strip 2

You can see Sleeping Drug here.

>give hobo change
You can't see any such thing.

>take drug
Taken.

>east
Strip 2
This is the second half of the strip.  To the North is the Happy Shooting.  To the South is the Cafe.  To the West is the Strip 1.

You can see Hobo here.

* * *

>open container
You open Secret Container.

>west
Strip 1
This is the first half of the strip.  To the south is Longs, to the north is the Yoga Studio, and to the east is the Strip 2

>south
Longs
It's just like every other Longs store. The Laxatives can be found in the Drug Cabinet.

You can see Security Guard and Drug Cabinet (closed) here.

* * *

>south
Cafe
An empty cafe with rows of emtpy tables.  In the corner of the room is a Old man drinking coffee and reading the newspaper.  On his table is a Silver Key.

You can see Old Man, Coffee (empty), Newspaper and Silver Key here.

>put drug in coffee
You put Sleeping Drug into Coffee.

* * *

>south
Strip 1
This is the first half of the strip.  To the south is Longs, to the north is the Yoga Studio, and to the east is the Strip 2

You can see Sleeping Drug here.

>north
Yoga Studio
You and your Yoga Instructor are the only people in the room.  You were having a private yoga session because your psychiatrist recommended it would help; You know, with your anger issues and such.  In the corner of the room is a stack of yoga mats. To the south is the Strip.

You can see a Restroom Door and Yoga Instructor here.

* * *

>south
Strip 1
This is the first half of the strip.  To the south is Longs, to the north is the Yoga Studio, and to the east is the Strip 2

You can see Sleeping Drug here.

>take drug
Taken.

* * *

>south
Cafe
An empty cafe with rows of emtpy tables.  In the corner of the room is a Old man drinking coffee and reading the newspaper.  On his table is a Silver Key.

You can see Old Man, Cup (in which is Coffee), Newspaper and Silver Key here.

>take cup
As you pick up the Old Man's Coffee, he quickly takes it back.

>put sleeping drug in cup
You put Sleeping Drug into Cup.

* * *

>take
What do you want to take?

* * *

>south
Cafe
An empty cafe with rows of emtpy tables.  In the corner of the room is a Old man drinking coffee and reading the newspaper.  On his table is a Silver Key.

You can see Old Man, Cup (in which is Coffee), Newspaper and Silver Key here.

>put drug in coffee
You put Sleeping Drug into Coffee.

>take silver key
You take the man's silver key while he is asleep.

* * *

>north
Happy Shooting
This gun store is void of all life.  The interior of the store is a very dull grey color that is completely opposite of the store's name. In the back of the room, there is a cabinent that is filled with guns.  In the top corner of the room, there is a security camera that can that view your every move.  Just outside the camera's view is a door.  To the East is the Security Room, which is locked, and to the South is the Strip 2.

You can see a metal door and a Steel Cabinet (closed) here.

>open cabinet
It seems to be locked.

>open metal door
It seems to be locked.

>unlock metal door
What do you want to unlock the metal door with?

* * *

>open metal door
You open the metal door.

>open metal door
That's already open.

>east
Security Room
This room has one monitor screen that overlooks the Gun Store.  Below the monitor is a Red Switch.

You can see a metal door, Case Key and Red Switch here.

>x case key
It unlocks the gun cabinent.

* * *

>north
Happy Shooting
This gun store is void of all life.  The interior of the store is a very dull grey color that is completely opposite of the store's name. In the back of the room, there is a cabinent that is filled with guns.  In the top corner of the room, there is a security camera that can that view your every move.  Just outside the camera's view is a door.  To the East is the Security Room, which is locked, and to the South is the Strip 2.

You can see a metal door and a Steel Cabinet (closed) here.

>open metal door
It seems to be locked.

>unlock metald door with silver key
You can't see any such thing.

>unlock metal door
What do you want to unlock the metal door with?

* * *

>east
(first opening the metal door)

Security Room
This room has one monitor screen that overlooks the Gun Store.  Below the monitor is a Red Switch.

You can see a metal door, Case Key and Red Switch here.

>press red switch
Nothing obvious happens.

* * *

>put drug in cup
You put Sleeping Drug into Cup.

>north
Strip 2
This is the second half of the strip.  To the North is the Happy Shooting.  To the South is the Cafe.  To the West is the Strip 1.

You can see Hobo here.

>south
Cafe
An empty cafe with rows of emtpy tables.  In the corner of the room is a Old man drinking coffee and reading the newspaper.  On his table is a Silver Key.

You can see Old Man, Cup (in which are Sleeping Drug and Coffee), Newspaper and Silver Key here.

>ake key
That's not a verb I recognise.

>take key
You take the man's silver key while he is asleep.

* * *

>east
(first opening the metal door)

Security Room
This room has one monitor screen that overlooks the Gun Store.  Below the monitor is a Red Switch.

You can see a metal door, Case Key and Red Switch here.

>turn red switch on
You switch Red Switch on.

* * *

>east
Strip 2
This is the second half of the strip.  To the North is the Happy Shooting.  To the South is the Cafe.  To the West is the Strip 1.

You can see Hobo here.

>east
You can't go that way.

>south
Cafe
An empty cafe with rows of emtpy tables.  In the corner of the room is a Old man drinking coffee and reading the newspaper.  On his table is a Silver Key.

You can see Old Man, Cup (in which is Coffee), Newspaper and Silver Key here.

* * *

>put drug in cup
You put Sleeping Drug into Cup.

>take silver key
You take the man's silver key while he is asleep.

>north
Strip 2
This is the second half of the strip.  To the North is the Happy Shooting.  To the South is the Cafe.  To the West is the Strip 1.

You can see Hobo here.

>norht
That's not a verb I recognise.

>north
Happy Shooting
This gun store is void of all life.  The interior of the store is a very dull grey color that is completely opposite of the store's name. In the back of the room, there is a cabinent that is filled with guns.  In the top corner of the room, there is a security camera that can that view your every move.  Just outside the camera's view is a door.

You can see a metal door and a Cabinent (closed) here.

>open cabinet
You can't see any such thing.

* * *

>open restroom door
"Hey! It's in use! Wait…  You need to use the restroom too?  Well it seems we can help each other.  If you want to use the restroom, go get me medicine," says the mysterious voice on the other side of the door.

>south
Strip 1
This is the first half of the strip.  To the south is Longs, to the north is the Yoga Studio, and to the east is the Strip 2

You can see Sleeping Drug here.

* * *

>give hobo change
Hobo is so happy that he gives you his cherished item.

>west
Strip 1
This is the first half of the strip.  To the south is Longs, to the north is the Yoga Studio, and to the east is the Strip 2

You can see Sleeping Drug here.

* * *

>open cabinet
You open Drug Cabinet, revealing Medicine.

>open secret container
You open Secret Container.

>take medicine
Taken.

* * *

>east
(first opening the Restroom Door)
"Hey! It's in use! Wait…  You need to use the restroom too?  Well it seems we can help each other.  If you want to use the restroom, go get me medicine," says the mysterious voice on the other side of the door. When you do, slip the medicine under the door.

>south
Strip 1
This is the first half of the strip.  To the south is Longs, to the north is the Yoga Studio, and to the east is the Strip 2

You can see Sleeping Drug here.

* * *

>east
Strip 2
This is the second half of the strip.  To the North is the Happy Shooting.  To the South is the Cafe.  To the West is the Strip 1.

You can see Hobo here.

>south
Cafe
An empty cafe with rows of emtpy tables.  In the corner of the room is a Old man drinking coffee and reading the newspaper.  On his table is a Silver Key.

You can see Old Man, Coffee (in which is Milk), Newspaper and Silver Key here.

* * *

>open door
"Hey! It's in use! Wait…  You need to use the restroom too?  Well it seems we can help each other.  If you want to use the restroom, go get me medicine," says the mysterious voice on the other side of the door. When you do, slip the medicine under the door.

>south
Strip 1
This is the first half of the strip.  To the south is Longs, to the north is the Yoga Studio, and to the east is the Strip 2

You can see Sleeping Drug here.

* * *

>take medicine
Taken.

>put medicine in secret container
You put Medicine into Secret Container.

>north
Strip 1
This is the first half of the strip.  To the south is Longs, to the north is the Yoga Studio, and to the east is the Strip 2

You can see Sleeping Drug here.

* * *

>north
Yoga Studio
You and your Yoga Instructor are the only people in the room.  You were having a private yoga session because your psychiatrist recommended it would help; You know, with your anger issues and such.  In the corner of the room is a stack of yoga mats. To the south is the Strip.

You can see a Restroom Door and Yoga Instructor here.

>slip medicine under door
Thanks You! But it would seem the door is jammed… If you want to use the bathroom, you'll need to find a way to open this door.

>open door
You need to find a way to get the door open

>south
Strip 1
This is the first half of the strip.  To the south is Longs, to the north is the Yoga Studio, and to the east is the Strip 2

You can see Sleeping Drug here.

* * *

>x sleeping drug
If mixed in a liquid, it would become a very potent.

>east
Strip 2
This is the second half of the strip.  To the North is the Happy Shooting.  To the South is the Cafe.  To the West is the Strip 1.

You can see Hobo here.

>south
Cafe
An empty cafe with rows of emtpy tables.  In the corner of the room is a Old man drinking coffee and reading the newspaper.  On his table is a Silver Key.

You can see Old Man, Coffee, Newspaper and Silver Key here.

>talk to old man
You can't see any such thing.

>talk to Old man
You can't see any such thing.

* * *

>slip medicine under door
Thanks You! But it would seem the door is jammed… If you want to use the bathroom, you'll need to find a way to open this door.

>open door
"Hey! It's in use! Wait…  You need to use the restroom too?  Well it seems we can help each other.  If you want to use the restroom, go get me medicine," says the mysterious voice on the other side of the door. When you do, slip the medicine under the door.
You need to find a way to get the door open

* * *

>ast
That's not a verb I recognise.

>south
Strip 1
This is the first half of the strip.  To the south is Longs, to the north is the Yoga Studio, and to the east is the Strip 2

You can see Sleeping Drug here.

* * *

>take drug
Taken.

>easet
That's not a verb I recognise.

>east
Strip 2
This is the second half of the strip.  To the North is the Happy Shooting.  To the South is the Cafe.  To the West is the Strip 1.

You can see Hobo here.

* * *

>east
(first opening the metal door)

Security Room
This room has one monitor screen that overlooks the Gun Store.  Below the monitor is a Red Switch.

You can see a metal door, Case Key and Red Switch here.

>x red switch
It seems to toggle the Security Camera. .

Red Switch is currently switched off.

>turn red switch on
You switch Red Switch on.

>x red switch
It seems to toggle the Security Camera.  At the moment, the security camera is disabled.

Red Switch is currently switched on.

>take key
(Case Key)
Taken.

>west
Happy Shooting
This gun store is void of all life.  The interior of the store is a very dull grey color that is completely opposite of the store's name. In the back of the room, there is a cabinent that is filled with guns.  In the top corner of the room, there is a security camera that can that view your every move.  Just outside the camera's view is a door.  To the East is the Security Room, which is locked, and to the South is the Strip 2.

You can see a metal door and a Steel Cabinet (closed) here.

* * *

>north
Yoga Studio
You and your Yoga Instructor are the only people in the room.  You were having a private yoga session because your psychiatrist recommended it would help; You know, with your anger issues and such.  In the corner of the room is a stack of yoga mats. To the south is the Strip.

You can see a Restroom Door and Yoga Instructor here.

>shoot door
You shoot the Restroom door and it breaks open.  You Proudly walk into the Bathroom.

Bathroom
FREEEEDOM! YOU CAN FINALLY USE THE TOILET!

You can see a Restroom Door and Ted here.

    *** You have won ***

In that game you scored 0 out of a possible 0, in 22 turns.

Would you like to RESTART, RESTORE a saved game, QUIT or UNDO the last command?