Did she hear that? I was just trying to do a downward dog… Why did my body have to betray me like that?  I hope she doesn't smell that…  My stomach really hurts.  I should use the restroom.

Bowel Troubles
An Interactive Fiction by Kyler Matsuura
Release 1 / Serial number 140311 / Inform 7 build 6G60 (I6/v6.32 lib 6/12N) SD

Yoga Studio
You and your Yoga Instructor are the only people in the room.  You were having a private yoga session because your psychiatrist recommended it would help; You know, with your anger issues and such.  In the corner of the room is a stack of yoga mats. To the south is the Strip.

You can see a Restroom Door and Yoga Instructor here.

I beg your pardon?

I beg your pardon?

* * *

>open restroom door
"Hey! It's in use! Wait…  You need to use the restroom too?  Well it seems we can help each other.  If you want to use the restroom, go get me medicine," says the mysterious voice on the other side of the door. When you do, slip the medicine under the door.

>south
Strip 1
This is the first half of the strip.  Every store that is usually opened during the day is closed.  The only store open right now is Longs, which is perfect because they have medicine for your friend in the bathroom.  To the south is Longs, to the north is the Yoga Studio, and to the east is the Strip 2

You can see Sleeping Drug here.

>east
Strip 2
This is the second half of the strip.  Just like the first half, almost all the stores are closed.  To the North is the Happy Shooting.  To the South is the Cafe.  To the West is the Strip 1.

You can see Hobo here.

>give change to hobo
Hobo is so happy that he gives you his cherished item.

>west
Strip 1
This is the first half of the strip.  Every store that is usually opened during the day is closed.  The only store open right now is Longs, which is perfect because they have medicine for you friend in the bathroom.  On either side of you, there are beautiful palm trees. To the south is Longs, to the north is the Yoga Studio, and to the east is the Strip 2

You can see Sleeping Drug here.

>south
Longs
It's just like every other Longs store, except for the fact it's completely void of anything except medicine.  About two days ago, there was a tsunami warning and everyone freaked out and bought everything in Longs expecting the tsunami to competely cover Hawaii;  The tsunami turned out to be two inches.  The medicine can be found in the Drug Cabinet.  To the North is the Strip 1.

You can see Security Guard and Drug Cabinet (closed) here.

>open drug cabinet
You open Drug Cabinet, revealing Medicine.

>take medicine
Taken.

>open secret container
You open Secret Container.

>put medicine in secret container
You put Medicine into Secret Container.

>north
Strip 1
This is the first half of the strip.  Every store that is usually opened during the day is closed.  The only store open right now is Longs, which is perfect because they have medicine for you friend in the bathroom.  On either side of you, there are beautiful palm trees. To the south is Longs, to the north is the Yoga Studio, and to the east is the Strip 2

You can see Sleeping Drug here.

>north
Yoga Studio
You and your Yoga Instructor are the only people in the room.  You were having a private yoga session because your psychiatrist recommended it would help; You know, with your anger issues and such.  In the corner of the room is a stack of yoga mats. To the south is the Strip.

You can see a Restroom Door and Yoga Instructor here.

>Open Restroom Door
"Hey! It's in use! Wait…  You need to use the restroom too?  Well it seems we can help each other.  If you want to use the restroom, go get me medicine," says the mysterious voice on the other side of the door. When you do, slip the medicine under the door.

>slip medicine under door
Thanks You! But it would seem the door is jammed… If you want to use the bathroom, you'll need to find a way to open this door.  Maybe you could shoot this door down.  Only if you had a gun...

>undo
Yoga Studio
[Previous turn undone.]

>undo
Yoga Studio
[Previous turn undone.]

>undo
Strip 1
[Previous turn undone.]

>l
Strip 1
This is the first half of the strip.  Every store that is usually opened during the day is closed.  The only store open right now is Longs, which is perfect because they have medicine for you friend in the bathroom.  On either side of you, there are beautiful palm trees. To the south is Longs, to the north is the Yoga Studio, and to the east is the Strip 2

You can see Sleeping Drug here.

>north
Yoga Studio
You and your Yoga Instructor are the only people in the room.  You were having a private yoga session because your psychiatrist recommended it would help; You know, with your anger issues and such.  In the corner of the room is a stack of yoga mats. To the south is the Strip.

You can see a Restroom Door and Yoga Instructor here.

>slip medicine under door
Thanks You! But it would seem the door is jammed… If you want to use the bathroom, you㺠ᅳ'll need to find a way to open this door.  Maybe you could shoot this door down.  Only if you had a gun...

>south
Strip 1
This is the first half of the strip.  Every store that is usually opened during the day is closed.  The only store open right now is Longs, which is perfect because they have medicine for you friend in the bathroom.  On either side of you, there are beautiful palm trees. To the south is Longs, to the north is the Yoga Studio, and to the east is the Strip 2

You can see Sleeping Drug here.

>take sleeping drug
Taken.

>east
Strip 2
This is the second half of the strip.  Just like the first half, almost all the stores are closed.  To the North is the Happy Shooting.  To the South is the Cafe.  To the West is the Strip 1.

You can see Hobo here.

>south
Cafe
An empty cafe with rows of emtpy tables.  It seems like the Cafe was just about to close. In the corner of the room, there is a Old man drinking coffee and reading the newspaper.  On his table is a Silver Key.  To the North is the Strip 2.

You can see Old Man, Cup (in which is Coffee), Newspaper and Silver Key here.

>Put sleeping drug in cup
You put Sleeping Drug into Cup.

>take Silver key
You take the Old Man's Silver Key while he's fast asleep.  That sleeping drug you put in his medicine is very potent.

* * *

>east
Strip 2
This is the second half of the strip.  Just like the first half, almost all the stores are closed.  To the North is the Happy Shooting.  To the South is the Cafe.  To the West is the Strip 1.

You can see Hobo here.

>west
Strip 1
This is the first half of the strip.  Every store that is usually opened during the day is closed.  The only store open right now is Longs, which is perfect because they have medicine for your friend in the bathroom.  To the south is Longs, to the north is the Yoga Studio, and to the east is the Strip 2

You can see Sleeping Drug here.

>take drug
Taken.

>south
Longs
It's just like every other Longs store, except for the fact it's completely void of anything except medicine.  About two days ago, there was a tsunami warning and everyone freaked out and bought everything in Longs expecting the tsunami to competely cover Hawaii;  The tsunami turned out to be two inches.  The medicine can be found in the Drug Cabinet.  To the North is the Strip 1.

You can see Security Guard and Drug Cabinet (closed) here.

>north
Strip 1
This is the first half of the strip.  Every store that is usually opened during the day is closed.  The only store open right now is Longs, which is perfect because they have medicine for your friend in the bathroom.  To the south is Longs, to the north is the Yoga Studio, and to the east is the Strip 2

>east
Strip 2
This is the second half of the strip.  Just like the first half, almost all the stores are closed.  To the North is the Happy Shooting.  To the South is the Cafe.  To the West is the Strip 1.

You can see Hobo here.

* * *

>south
Cafe
An empty cafe with rows of emtpy tables.  It seems like the Cafe was just about to close. In the corner of the room, there is a Old man drinking coffee and reading the newspaper.  On his table is a Silver Key.  To the North is the Strip 2.

You can see Old Man, Cup (in which is Coffee), Newspaper and Silver Key here.

>put drug in cup
You put Sleeping Drug into Cup.

>take key
You take the Old Man's Silver Key while he's fast asleep.  That sleeping drug you put in his coffee is very potent.

>north
Strip 2
This is the second half of the strip.  Just like the first half, almost all the stores are closed.  To the North is the Happy Shooting.  To the South is the Cafe.  To the West is the Strip 1.

You can see Hobo here.

>north
Happy Shooting
This gun store is void of all life.  The interior of the store is a very dull grey color that is completely opposite of the store's name. In the back of the room, there is a cabinent that is filled with guns.  In the top corner of the room, there is a security camera that can that view your every move.  Just outside the camera's view is a door.  To the East is the Security Room, which is locked, and to the South is the Strip 2.

You can see a metal door and a Steel Cabinet (closed) here.

>unlock metal door
What do you want to unlock the metal door with?

>east
You can't see any such thing.

>key
That's not a verb I recognise.

>unlock metal door
What do you want to unlock the metal door with?

>key
You unlock the metal door.

>east
(first opening the metal door)

Security Room
This room has one monitor screen that overlooks the Gun Store.  Below the monitor is a Red Switch.

You can see a metal door, Case Key and Red Switch here.

>red switch on
That's not a verb I recognise.

>switch red switch on
You switch Red Switch on.

>take case key
Taken.

>west
Happy Shooting
This gun store is void of all life.  The interior of the store is a very dull grey color that is completely opposite of the store's name. In the back of the room, there is a cabinent that is filled with guns.  In the top corner of the room, there is a security camera that can that view your every move.  Just outside the camera's view is a door.  To the East is the Security Room, which is locked, and to the South is the Strip 2.

You can see a metal door and a Steel Cabinet (closed) here.

>unlock steel cabinet with case key
You unlock the Steel Cabinet.

>open cabinet
You open the Steel Cabinet, revealing Gun.

>take gun
You pick up the Gun and quickly hide it in your pocket.

>south
Strip 2
This is the second half of the strip.  Just like the first half, almost all the stores are closed.  To the North is the Happy Shooting.  To the South is the Cafe.  To the West is the Strip 1.

You can see Hobo here.

>west
Strip 1
This is the first half of the strip.  Every store that is usually opened during the day is closed.  The only store open right now is Longs, which is perfect because they have medicine for your friend in the bathroom.  To the south is Longs, to the north is the Yoga Studio, and to the east is the Strip 2

>north
Yoga Studio
You and your Yoga Instructor are the only people in the room.  You were having a private yoga session because your psychiatrist recommended it would help; You know, with your anger issues and such.  In the corner of the room is a stack of yoga mats. To the south is the Strip.

You can see a Restroom Door and Yoga Instructor here.

>open restroom door
"Hey! It's in use! Wait…  You need to use the restroom too?  Well it seems we can help each other.  If you want to use the restroom, go get me medicine," says the mysterious voice on the other side of the door. When you do, slip the medicine under the door.

>shoot door
You shoot the Restroom door and it breaks open.  You Proudly walk into the Bathroom.

Bathroom
FREEEEDOM! YOU CAN FINALLY USE THE TOILET!

You can see a Restroom Door and Ted here.

    *** You have won ***

In that game you scored 0 out of a possible 0, in 26 turns.

Would you like to RESTART, RESTORE a saved game, QUIT or UNDO the last command?

* * *

>x yoga mats
A stack of dirty yoga mats.  It seems that they were recently used.

>x me
You're a tall, pale white man.  You have blisters on your knuckles from punching your wall because you nerd raged while playing Call of Duty.  Your hair is greasy and messy because you haven't showered in days.  You look disgusting.

>talk to yoga instructor
"You need to use the restroom?  It's to the east."

>x instructor
A 60 year old women who has bigger muscles than you do.  Close up, you can smell the scent of fresh vegetables.

>east
(first opening the Restroom Door)
"Hey! It's in use! Wait…  You need to use the restroom too?  Well it seems we can help each other.  If you want to use the restroom, go get me medicine," says the mysterious voice on the other side of the door. When you do, slip the medicine under the door.

>south
Strip 1
This is the first half of the strip.  Every store that is usually opened during the day is closed.  The only store open right now is Longs, which is perfect because they have medicine for you friend in the bathroom.  To the south is Longs, to the north is the Yoga Studio, and to the east is the Strip 2

You can see Sleeping Drug here.

>take sleeping drug
Taken.

>x sleeping drug
If mixed in a liquid, it would become a very potent.

>eat drug
That's plainly inedible.

>south
Longs
It's just like every other Longs store, except for the fact it's completely void of anything except medicine.  About two days ago, there was a tsunami warning and everyone freaked out and bought everything in Longs expecting the tsunami to competely cover Hawaii;  The tsunami turned out to be two inches.  The medicine can be found in the Drug Cabinet.  To the North is the Strip 1.

You can see Security Guard and Drug Cabinet (closed) here.

>x security guard
He looks about 7 ft tall.  You don't want to be caught stealing by him.

>talk to security guard
As you approach the oversized man, he looks at you; and you soon realize it would be a bad idea to talk to him.

>x drug cabinet
It contains the medecine you seek…

>open drug cabinet
You open Drug Cabinet, revealing Medicine.

>north
Strip 1
This is the first half of the strip.  Every store that is usually opened during the day is closed.  The only store open right now is Longs, which is perfect because they have medicine for you friend in the bathroom.  To the south is Longs, to the north is the Yoga Studio, and to the east is the Strip 2

>east
Strip 2
This is the second half of the strip.  Just like the first half, almost all the stores are closed.  To the North is the Happy Shooting.  To the South is the Cafe.  To the West is the Strip 1.

You can see Hobo here.

>x hobo
A smelly homesless person.  Hobo looks unhappy.   He seems to be holding a secret container.  You should talk to him.

>talk to hobo
As you begin to speak, the Hobo cuts you off and asks for change; while pointing at your pocket.

>give hobo change
Hobo is so happy that he gives you his cherished item.

>i
You are carrying:
  Secret Container (closed)
  Sleeping Drug

>open secret container
You open Secret Container.

>west
Strip 1
This is the first half of the strip.  Every store that is usually opened during the day is closed.  The only store open right now is Longs, which is perfect because they have medicine for you friend in the bathroom.  To the south is Longs, to the north is the Yoga Studio, and to the east is the Strip 2

>south
Longs
It's just like every other Longs store, except for the fact it's completely void of anything except medicine.  About two days ago, there was a tsunami warning and everyone freaked out and bought everything in Longs expecting the tsunami to competely cover Hawaii;  The tsunami turned out to be two inches.  The medicine can be found in the Drug Cabinet.  To the North is the Strip 1.

You can see Security Guard and Drug Cabinet (in which is Medicine) here.

>take medicine
Taken.

>put medicine in container
You put Medicine into Secret Container.

>north
Strip 1
This is the first half of the strip.  Every store that is usually opened during the day is closed.  The only store open right now is Longs, which is perfect because they have medicine for you friend in the bathroom.  To the south is Longs, to the north is the Yoga Studio, and to the east is the Strip 2

* * *

>south
Cafe
An empty cafe with rows of emtpy tables.  It seems like the Cafe was just about to close. In the corner of the room, there is a Old man drinking coffee and reading the newspaper.  On his table is a Silver Key.  To the North is the Strip 2.

You can see Old Man, Cup (in which is Coffee), Newspaper and Silver Key here.

>x row of tables
You can't see any such thing.

>x row of empty tables
You can't see any such thing.

>x tables
You can't see any such thing.

>x table
This particular table is just like every other table in the room.  The table in the corner of the room has a Silver Key on it, but it seems to be the Old Man's.

* * *

>south
Strip 1
This is the first half of the strip.  Every store that is usually opened during the day is closed.  The only store open right now is Longs, which is perfect because they have medicine for your friend in the bathroom.  To the south is Longs, to the north is the Yoga Studio, and to the east is the Strip 2

You can see Sleeping Drug here.

>climb tree
You can't see any such thing.

>climb palm tree
I only understood you as far as wanting to climb Palm Trees.

* * *

>south
Strip 1
This is the first half of the strip.  Every store that is usually opened during the day is closed.  The only store open right now is Longs, which is perfect because they have medicine for your friend in the bathroom.  To the south is Longs, to the north is the Yoga Studio, and to the east is the Strip 2

You can see Sleeping Drug here.

>climb palm tree
I only understood you as far as wanting to climb Palm Trees.

* * *

>south
Strip 1
This is the first half of the strip.  Every store that is usually opened during the day is closed.  The only store open right now is Longs, which is perfect because they have medicine for your friend in the bathroom.  To the south is Longs, to the north is the Yoga Studio, and to the east is the Strip 2

You can see Sleeping Drug here.

>take sleeping drug
Taken.

* * *

>south
Strip 1
This is the first half of the strip.  Every store that is usually opened during the day is closed.  The only store open right now is Longs, which is perfect because they have medicine for your friend in the bathroom.  To the south is Longs, to the north is the Yoga Studio, and to the east is the Strip 2

You can see Sleeping Drug here.

>south
Longs
It's just like every other Longs store, except for the fact it's completely void of anything except medicine.  About two days ago, there was a tsunami warning and everyone freaked out and bought everything in Longs expecting the tsunami to competely cover Hawaii;  The tsunami turned out to be two inches.  The medicine can be found in the Drug Cabinet.  To the North is the Strip 1.

You can see Security Guard and Drug Cabinet (closed) here.

>north
Strip 1
This is the first half of the strip.  Every store that is usually opened during the day is closed.  The only store open right now is Longs, which is perfect because they have medicine for you friend in the bathroom.  On either side of you, there are beautiful palm trees. To the south is Longs, to the north is the Yoga Studio, and to the east is the Strip 2

You can see Sleeping Drug here.

>east
Strip 2
This is the second half of the strip.  Just like the first half, almost all the stores are closed.  To the North is the Happy Shooting.  To the South is the Cafe.  To the West is the Strip 1.

You can see Hobo here.

>north
Happy Shooting
This gun store is void of all life.  The interior of the store is a very dull grey color that is completely opposite of the store's name. In the back of the room, there is a cabinent that is filled with guns.  In the top corner of the room, there is a security camera that can that view your every move.  Just outside the camera's view is a door.  To the East is the Security Room, which is locked, and to the South is the Strip 2.

You can see a metal door and a Steel Cabinet (closed) here.

>south
Strip 2
This is the second half of the strip.  Just like the first half, almost all the stores are closed.  To the North is the Happy Shooting.  To the South is the Cafe.  To the West is the Strip 1.

You can see Hobo here.

>south
Cafe
An empty cafe with rows of emtpy tables.  It seems like the Cafe was just about to close. In the corner of the room, there is a Old man drinking coffee and reading the newspaper.  On his table is a Silver Key.  To the North is the Strip 2.

You can see Old Man, Cup (in which is Coffee), Newspaper and Silver Key here.

>north
Strip 2
This is the second half of the strip.  Just like the first half, almost all the stores are closed.  To the North is the Happy Shooting.  To the South is the Cafe.  To the West is the Strip 1.

You can see Hobo here.

* * *

>south
Strip 1
This is the first half of the strip.  Every store that is usually opened during the day is closed.  The only store open right now is Longs, which is perfect because they have medicine for your friend in the bathroom.  To the south is Longs, to the north is the Yoga Studio, and to the east is the Strip 2

You can see Sleeping Drug here.

>take drug
Taken.

>east
Strip 2
This is the second half of the strip.  Just like the first half, almost all the stores are closed.  To the North is the Happy Shooting.  To the South is the Cafe.  To the West is the Strip 1.

You can see Hobo here.

* * *

>north
Happy Shooting
This gun store is void of all life.  The interior of the store is a very dull grey color that is completely opposite of the store's name. In the back of the room, there is a cabinent that is filled with guns.  In the top corner of the room, there is a security camera that can that view your every move.  Just outside the camera's view is a door.  To the East is the Security Room, which is locked, and to the South is the Strip 2.

You can see a metal door and a Steel Cabinet (closed) here.

>x steel cabinet
A large cabinent that seems to be emptier than it seems.

>east
(first opening the metal door)
It seems to be locked.

>unlock metal door
What do you want to unlock the metal door with?

>silver key
You unlock the metal door.

>east
(first opening the metal door)

Security Room
This room has one monitor screen that overlooks the Gun Store.  Below the monitor is a Red Switch.

You can see a metal door, Case Key and Red Switch here.

>x monitor
You can't see any such thing.

>take case key
Taken.

>x case key
It unlocks the gun cabinent.

>x red switch
It seems to toggle the Security Camera. .

Red Switch is currently switched off.

>switch red switch on
You switch Red Switch on.

>west
Happy Shooting
This gun store is void of all life.  The interior of the store is a very dull grey color that is completely opposite of the store's name. In the back of the room, there is a cabinent that is filled with guns.  In the top corner of the room, there is a security camera that can that view your every move.  Just outside the camera's view is a door.  To the East is the Security Room, which is locked, and to the South is the Strip 2.

You can see a metal door and a Steel Cabinet (closed) here.

>unlock steel cabinet
What do you want to unlock the Steel Cabinet with?

>case key
You unlock the Steel Cabinet.

>open cabinet
You open the Steel Cabinet, revealing Gun.

>x gun
You never held one before. You can feel the power of the gun flowing through your veins.  The taste of freedom is on the tip of your tounge.

>south
Strip 2
This is the second half of the strip.  Just like the first half, almost all the stores are closed.  To the North is the Happy Shooting.  To the South is the Cafe.  To the West is the Strip 1.

You can see Hobo here.

* * *

>west
Strip 1
This is the first half of the strip.  Every store that is usually opened during the day is closed.  The only store open right now is Longs, which is perfect because they have medicine for your friend in the bathroom.  To the south is Longs, to the north is the Yoga Studio, and to the east is the Strip 2

>west
You can't go that way.

>north
Yoga Studio
You and your Yoga Instructor are the only people in the room.  You were having a private yoga session because your psychiatrist recommended it would help; You know, with your anger issues and such.  In the corner of the room is a stack of yoga mats. To the south is the Strip.

You can see a Restroom Door and Yoga Instructor here.

>open restroom door
"Hey! It's in use! Wait…  You need to use the restroom too?  Well it seems we can help each other.  If you want to use the restroom, go get me medicine," says the mysterious voice on the other side of the door. When you do, slip the medicine under the door.
"Hey man, thanks for getting me out.  Bathroom is all yours," says the man as he leaves the bathroom.

* * *

>put drug in cup
You put Sleeping Drug into Cup.

>take silver key
You take the Old Man's Silver Key while he's fast asleep.  That sleeping drug you put in his coffee is very potent.

>north
Strip 2
This is the second half of the strip.  Just like the first half, almost all the stores are closed.  To the North is the Happy Shooting.  To the South is the Cafe.  To the West is the Strip 1.

You can see Hobo here.

>east
You can't go that way.

>north
Happy Shooting
This gun store is void of all life.  The interior of the store is a very dull grey color that is completely opposite of the store's name. In the back of the room, there is a cabinent that is filled with guns.  In the top corner of the room, there is a security camera that can that view your every move.  Just outside the camera's view is a door.  To the East is the Security Room, which is locked, and to the South is the Strip 2.

You can see a metal door and a Steel Cabinet (closed) here.

* * *

>east
(first opening the metal door)

Security Room
This room has one monitor screen that overlooks the Gun Store.  Below the monitor is a Red Switch.

You can see a metal door, Case Key and Red Switch here.

>x monitor
You can see the everything in the Gun Store on this screen

* * *

>south
Cafe
An empty cafe with rows of emtpy tables.  It seems like the Cafe was just about to close. In the corner of the room, there is a Old man drinking coffee and reading the newspaper.  On his table is a Silver Key.  To the North is the Strip 2.

You can see Old Man, Cup (in which is Coffee), Newspaper and Silver Key here.

>put sleeping drug in cup
You put Sleeping Drug into Cup.

>take silver key
You take the Old Man's Silver Key while he's fast asleep.  That sleeping drug you put in his coffee is very potent.

* * *

>north
Happy Shooting
This gun store is void of all life.  The interior of the store is a very dull grey color that is completely opposite of the store's name. In the back of the room, there is a cabinent that is filled with guns.  In the top corner of the room, there is a security camera that can that view your every move.  Just outside the camera's view is a door.  To the East is the Security Room, which is locked, and to the South is the Strip 2.

You can see a metal door and a Steel Cabinet (closed) here.

>Unlock metal door
What do you want to unlock the metal door with?

>Unlock metal door with silver key
You unlock the metal door.

>east
(first opening the metal door)

Security Room
This room has one monitor screen that overlooks the Gun Store.  Below the monitor is a Red Switch.

You can see a metal door, Case Key and Red Switch here.

>Switch Red Switch on
You switch Red Switch on.

>take case key
Taken.

* * *

>unlock steel cabinet
What do you want to unlock the Steel Cabinet with?

>unlock steel cabinet with case key
You unlock the Steel Cabinet.

>open steel cabinet
You open the Steel Cabinet, revealing Gun.

>take gun
You pick up the Gun and quickly hide it in your pocket.

* * *

>south
Strip 2
This is the second half of the strip.  Just like the first half, almost all the stores are closed.  To the North is the Happy Shooting.  To the South is the Cafe.  To the West is the Strip 1.

You can see Hobo here.

>west
Strip 1
This is the first half of the strip.  Every store that is usually opened during the day is closed.  The only store open right now is Longs, which is perfect because they have medicine for you friend in the bathroom.  On either side of you, there are beautiful palm trees. To the south is Longs, to the north is the Yoga Studio, and to the east is the Strip 2

>north
Yoga Studio
You and your Yoga Instructor are the only people in the room.  You were having a private yoga session because your psychiatrist recommended it would help; You know, with your anger issues and such.  In the corner of the room is a stack of yoga mats. To the south is the Strip.

You can see a Restroom Door and Yoga Instructor here.

>shoot restroom door with gun
You can't see any such thing.

>shoot restroom door
You shoot the Restroom door and it breaks open.  You Proudly walk into the Bathroom.

Bathroom
FREEEEDOM! YOU CAN FINALLY USE THE TOILET!

You can see a Restroom Door and Ted here.

    *** You have won ***

In that game you scored 0 out of a possible 0, in 20 turns.

Would you like to RESTART, RESTORE a saved game, QUIT or UNDO the last command?

>restar
Please give one of the answers above.

Would you like to RESTART, RESTORE a saved game, QUIT or UNDO the last command?

* * *

>south
Cafe
An empty cafe with rows of emtpy tables.  It seems like the Cafe was just about to close. In the corner of the room, there is a Old man drinking coffee and reading the newspaper.  On his table is a Silver Key.  To the North is the Strip 2.

You can see Old Man, Cup (in which is Coffee), Newspaper and Silver Key here.

>x tables
You can't see any such thing.

>x tables
You can't see any such thing.

* * *

>south
Cafe
An empty cafe with rows of emtpy tables.  It seems like the Cafe was just about to close. In the corner of the room, there is a Old man drinking coffee and reading the newspaper.  On his table is a Silver Key.  To the North is the Strip 2.

You can see Old Man, Cup (in which is Coffee), Newspaper and Silver Key here.

>x old man
He's dressed in rugged jeans and a Happy Shooting T-Shirt.  He seems to be reading the newspaper and drinking some coffee.  On his table is a Silver Key.

>put drug in cup
You put Sleeping Drug into Cup.

>x old man
He's dressed in rugged jeans and a Happy Shooting T-Shirt.  He seems to be reading the newspaper and drinking some coffee.  On his table is a Silver Key.  He seems to be asleep.

>take silver key
You take the Old Man's Silver Key while he's fast asleep.  That sleeping drug you put in his coffee is very potent.

* * *

>north
Happy Shooting
This gun store is void of all life.  The interior of the store is a very dull grey color that is completely opposite of the store's name. In the back of the room, there is a cabinent that is filled with guns.  In the top corner of the room, there is a security camera that can that view your every move.  Just outside the camera's view is a door.  To the East is the Security Room, which is locked, and to the South is the Strip 2.

You can see a metal door and a Steel Cabinet (closed) here.

>x security camera
It's in the top corner of the room way out of your reach.  You better disable the camera if you wish to steal anything in this room.

>x metal door
A large metal door that is locked shut.  It would seem that a special key is the only thing that can open the door…

>x steel cabinet
You see nothing special about the Steel Cabinet.

>x steel cabinet
You see nothing special about the Steel Cabinet.

* * *

>south
Cafe
An empty cafe with rows of emtpy tables.  It seems like the Cafe was just about to close. In the corner of the room, there is a Old man drinking coffee and reading the newspaper.  On his table is a Silver Key.  To the North is the Strip 2.

You can see Old Man, Cup (in which is Coffee), Newspaper and Silver Key here.

>x table
This particular table is just like every other table in the room.  The table in the corner of the room has a Silver Key on it, but it seems to be the Old Man's.

>xx row of empty tables
That's not a verb I recognise.

>x row of empty tables
All wooden tables with chairs on each chairs on each side.

>x tables
All wooden tables with chairs on each chairs on each side.

>x empty tables
All wooden tables with chairs on each chairs on each side.

>north
Strip 2
This is the second half of the strip.  Just like the first half, almost all the stores are closed.  To the North is the Happy Shooting.  To the South is the Cafe.  To the West is the Strip 1.

You can see Hobo here.

>west
Strip 1
This is the first half of the strip.  Every store that is usually opened during the day is closed.  The only store open right now is Longs, which is perfect because they have medicine for your friend in the bathroom.  To the south is Longs, to the north is the Yoga Studio, and to the east is the Strip 2

You can see Sleeping Drug here.

* * *

>x old man
He's dressed in rugged jeans and a Happy Shooting T-Shirt.  He seems to be reading the newspaper and drinking some coffee.  On his table is a Silver Key.

>x silver key
A silver key that seems to unlock a door…

>x cup
A cup that contains the Old Man's coffee.  You could put something into this cup…

In Cup is Coffee.

>read newspaper
Honolulu Star Advertiser.  The top story: Surfer jailed for attacking another Surfer.

>put drug in cup
You put Sleeping Drug into Cup.

>x old man
He's dressed in rugged jeans and a Happy Shooting T-Shirt.  He seems to be reading the newspaper and drinking some coffee.  On his table is a Silver Key.

* * *

>east
Strip 2
This is the second half of the strip.  Just like the first half, almost all the stores are closed.  To the North is the Happy Shooting.  To the South is the Cafe.  To the West is the Strip 1.

You can see Hobo here.

>east
You can't go that way.

>south
Cafe
An empty cafe with rows of emtpy tables.  It seems like the Cafe was just about to close. In the corner of the room, there is a Old man drinking coffee and reading the newspaper.  On his table is a Silver Key.  To the North is the Strip 2.

You can see Old Man, Cup (in which is Coffee), Newspaper and Silver Key here.

* * *

>south
Strip 1
This is the first half of the strip.  Every store that is usually opened during the day is closed.  The only store open right now is Longs, which is perfect because they have medicine for your friend in the bathroom.  To the south is Longs, to the north is the Yoga Studio, and to the east is the Strip 2

You can see Sleeping Drug here.

>x palm tree
I only understood you as far as wanting to examine Palm Trees.

* * *

>SOUTH
Strip 1
This is the first half of the strip.  Every store that is usually opened during the day is closed.  The only store open right now is Longs, which is perfect because they have medicine for you friend in the bathroom.  On either side of you, there are beautiful palm trees. To the south is Longs, to the north is the Yoga Studio, and to the east is the Strip 2

You can see Sleeping Drug here.

>clim tree
That's not a verb I recognise.

>climb tree
You can't see any such thing.

* * *

>climb palm tree
I only understood you as far as wanting to climb Palm Trees.

>climb palm trees
You probably shouldn't climb the tree right now.  You need to go to the bathroom. BADLY.

>climb bree
You can't see any such thing.

>climb tree
You can't see any such thing.